angristan/.git/config:	url = git@github.com:angristan/nixos-config
barrucadu/.git/config:	url = git@github.com:barrucadu/nixfiles.git
bobbbay/.git/config:	url = git@github.com:Bobbbay/dotfiles.git
burke/.git/config:	url = git@github.com:burke/b
cmacrae/.git/config:	url = git@github.com:cmacrae/.nixpkgs
colemickens-flake-example/.git/config:	url = git@github.com:colemickens/nixos-flake-example
davidtwco/.git/config:	url = git@github.com:davidtwco/veritas
dieracdelta/.git/config:	url = git@github.com:DieracDelta/flakes.git
divnix/.git/config:	url = git@github.com:divnix/devos
edeneast/.git/config:	url = git@github.com:edeneast/nyx
fufexan/.git/config:	url = git@github.com:fufexan/dotfiles.git
gytis-ivaskevicius/.git/config:	url = git@github.com:gytis-ivaskevicius/nixfiles.git
hlissner/.git/config:	url = git@github.com:hlissner/dotfiles
hugoreeves/.git/config:	url = git@github.com:hugoreeves/elemental
jordanisaacs/.git/config:	url = git@github.com:jordanisaacs/dotfiles
kclejeune/.git/config:	url = git@github.com:kclejeune/system
malob/.git/config:	url = git@github.com:malob/nixpkgs
mitchellh/.git/config:	url = git@github.com:mitchellh/nixos-config
mjhoy/.git/config:	url = git@github.com:mjhoy/dotfiles
mjlbach/.git/config:	url = git@github.com:mjlbach/nix-dotfiles
monadplus/.git/config:	url = git@github.com:monadplus/nixconfig
mt-caret/.git/config:	url = git@github.com:mt-caret/nix-config
nmattia/.git/config:	url = git@github.com:nmattia/homies
rasendubi/.git/config:	url = git@github.com:rasendubi/dotfiles
rprospero/.git/config:	url = https://gitlab.com/rprospero/dotfiles
sebastiant/.git/config:	url = git@github.com:sebastiant/dotfiles
shadowninja55/.git/config:	url = git@github.com:shadowninja55/nixos-config
shaunsingh/.git/config:	url = git@github.com:shaunsingh/nix-darwin-dotfiles
sjau/.git/config:	url = git@github.com:sjau/nixos
syberant/.git/config:	url = https://github.com/syberant/nix-config/
wiltaylor/.git/config:	url = git@github.com:wiltaylor/dotfiles
